1111111111111111
1CCC000000000111
1CCC000000000111
1CCC0000P0000111
1CC0000000000111
100C0000000E0111
1111111111111111




