1111111111111111111111111111111111
1111111111111111111111111111111111
1E100000001P000C00000C000000000001
1010010100100000101001000000010101
1010010010100101001001000C00010101
1010000001C00C0000C0000000000000C1
1C1000000C10C0000000100000010000C1
1000000000000000000000000000000001
1000000000001000001000000000000001
1000000000001000001000000000000001
1111111111111111111111111111111111